test	Это тестовый текст, это тестовый текст, это тестовый текст, это тестовый текст, это тестовый текст, это тестовый текст, это тестовый текст
efwfe	424346
fwefwe	2354543
rbdfbe	45364
button_next	Далее
intro_00	Что, хотите услышать историю о том, как благие намерения прикатили весь мир к краю пропасти?
intro_01	Тогда вам повезло, у меня как раз много свободного времени. Устраивайтесь поудобнее. В чего бы начать? Хм. В общем слушайте.
intro_02	Высокое развитие науки и техники позволило удовлетворить все ступени человеческой нужды
intro_03	Все, кроме самой высокой - признания и самореализации
intro_04	Воспитанные в эпоху вседозволенности, и лишенные всякой морали, отморозки и ублюдки нашли себе выгодное развлечение - охота на живых людей. 
intro_05	Нет ничего проще, чем прикрепить к оружию камеру, и транслировать всё происходящее в прямой эфир.
intro_06	Убешь парочку аборигенов на богом забытой планете - и ты очередная знаменитость. Деньги и слава - что в этом плохого?
intro_07	До недавнего времени планете Провинсиал-2 удавалось избежать такой печальной участи - уж слишком далеко от "циливилизации" она была.
intro_08	Однако что-то изменилось, и нетронутая, непуганная планета стала лакомым кусочком для убийц со всей галактики.
intro_09	Не желая отдавать свои жизни из-за прихоти нелюдей, многие энтузиасты начали искать дешевый, и эффективный способ защиты.
intro_10	Кто знал, что потребность в безопаности откроет новую страницу в истории всего человечества?
provincial_2_text	Планета провинсиал-2, настоящее время.
act_1_01	Этот человек - это ты. В твоем небольшом городе тебя знают как честного наемника, не упускающий возможности заработать.
act_1_02	Один из твоих постоянных работодателей, Джефф, оказался довольно неплохим человеком. Разговор между делом, по бутылке пива в местном баре - вот вы и лучшие друзья на свете.
act_1_03	Спустя некоторое время Джефф сообщил тебе, что хочет открыть тебе одну тайну, и предложить воистину необычную работу. 
act_1_04	Преисполненный догадками, ты направился в место, котрое Джефф назвал "секретная штаб квартира". И вот ты почти пришёл.
player_call_jeff	Джефф? Ты здесь?
jeff_call_answer	Минуту, сейчас выйду
jeff_01	Рад тебя видеть. Если ты еще не передумал, сейчас последний шанс забыть о моем предложении.
to_jeff_01	Ага. Щас. Я всю ночь в постели ворочался, фантазировал, что же у тебя там за секреты. 
to_jeff_02	Потом мне приснился сон, в котором что ты оказался рептилоидом, а потом мы катались по галактике. 
jeff_02	Ну, как хочешь. Стой тут, сейчас приду.
jeff_secret	В общем, вот, узрей же то, ради чего ты пришел
player_secret_reaction	Эммм. У меня смешанные чувства. Даже и не знаю. Что это?
jeff_secret_detail_01	Теперь слушай внимательно, это короткая, но важная история.
jeff_secret_detail_02	От надежного человека поступила информация о том, что на планету положили глаз опытные убийцы и отморозки.
jeff_secret_detail_03	Мы хотим защитить свои жизни и жизни тех, кто не может позаботися о себе сам.
jeff_secret_detail_04	Для этого мы построили этот механизм. Мы влили в него все сбережения и силы.
jeff_secret_detail_05	Человека, который должен был быть пилотом, арестовали и держат под стражей. Ты его замена.
jeff_secret_detail_06	Вопросы?
#
player_secret_question_01	К чему такие сложности?
player_secret_question_01_full	А зачем такие сложности? Какой-то огромный танк из-за кучки отморозов? Я думал, у нас есть вооруженная полиция. Пусть делают свою работу сами.
jeff_secret_answer_01_A	Всё не так просто. Эти нелюди, они не просто убивают людей, а транслируют всё происходящее в прямой эфир
jeff_secret_answer_01_B	У них огромная армия почитателей и фанатов, это большая известность, а вместе с ней и деньги.
jeff_secret_answer_01_C	Поэтому они могут позволить себе дорогое вооружение и защиту.
jeff_secret_answer_01_D	Какой бы отпор им не давали, они всегда возвращались с десятикратной огневой мощью, и мстили за то, что ты шел против их воли на глазах миллиона зрителей.
jeff_secret_answer_01_E	Один раз жители города умудрились разбить нос одному такому нелюду.
jeff_secret_answer_01_F	На следующий день город был испепелен дотла, а всем выжившим он продел кольцо через нос, и водил их по пустоши, пока они не умерли.
jeff_secret_answer_01_G	Подытожив всё вышесказанное, можно сделать вывод, что чем больше мы сопротивляемся, тем интереснее получается охота.
jeff_secret_answer_01_H	Именно поэтому нам нужно ультимативное оружие для защиты. Такое, что бы раз - и навсегда
#
player_secret_question_02	Почему именно я?
player_secret_question_02_full	А почему именно я? Что-то я не помню, что бы мою фотографию размещали на стенде "лучший пилот огромных хреновин, которые похожи на танк"
jeff_secret_answer_02_A	У меня не так много знакомых, которым можно доверять, а все остальные заняты другими делами.
player_secret_answer_01_A	И всё?###Пф, а я то надеялся хотя бы на "сами звезды предначертали нам ТЕБЯ, избранный"
#
player_secret_question_03	А почему это "тайна"? К чему такая конспирация?
player_secret_question_03_full	А почему это "тайна"? Я думал, следует раструбить на весь свет о том, что нам скоро конец и мы все умрем.
jeff_secret_answer_03_A	Во-первых, отморозки думают, что мы - аборигены, которые только вчера добыли огонь.
jeff_secret_answer_03_B	Пусть и дальше так думают. Если они узнают, что у нас есть эффективное средство нападения, они укрепят оборону своей базы.
jeff_secret_answer_03_C	Во-вторых, если оружейные барыги узнают обо всём, они пятикратно поднимут цены на свое барахло. Если вообще станут нам что-либо продавать.
jeff_secret_answer_03_D	В третьих, узнав об опасности для своих жизней, жители всех городов устремяться в Барентол, самый защищенный город
jeff_secret_answer_03_E	Даже если их туда впустят, они все рано не будут в безопасности. Одним махом будут сметены ВСЕ!
#
player_secret_question_04	Что это за хреновина? Интересно узнать.
player_secret_question_04_full	Что это за хреновина? Расскажи поподробнее.
jeff_secret_answer_04_A	Это - механоид пилотриуемого типа. Его собрали кучка инженеров и ученых буквально из металлолома.
jeff_secret_answer_04_B	Несмотря на то, что он выглядит словно мусорный бак, полный печали, он вполне боеспособен.
jeff_secret_answer_04_C	Энергощит, старый, но рабочий. Лучшая из винтовок, что мы смогли найти. Куча других нишевых обвесов. Чем богаты, тем и рады.
jeff_secret_answer_04_D	Собирали его здесь, в этом гараже. Кстати, ты тоже приложил руку к его созданию, выполняя мои контракты.
player_secret_answer_04_A	Ну, незачто.
#
player_have_no_questions	Вопросов нет.
player_have_no_questions_full	Вопросов нет. Что от меня сейчас требуется?
#
jeff_answer_mech_training_01	Так как ты видишь механоид впервые, мне нужно обучить тебя хотя бы базовому управлению.
jeff_answer_mech_training_02	Тут недалеко есть полигон, который я подготовил специально для тебя.###Залезай внутрь механоида
jeff_answer_mech_training_03	Отлично! Как там внутри?
player_in_mech_first_time	Кресло удобное, а вот потолок низковат.
jeff_answer_mech_training_04	Теперь поверни ключ зажигания
jeff_answer_mech_training_05	Поехали на полигон, я отпралю его координаты тебе на монитор.
training_wasd	Используйте клавиши W,A,S,D для передвижения в указанное место
jeff_answer_mech_training_06	Итак, теперь я дистанционно включаю оружие, и дам тебе немного пострелять.
jeff_answer_mech_training_07	Видишь эти бочки? Они символизируют живую силу противника. Расстреляй их.
training_shoot	Для ведения огня нажмите левую клавишу мыши
jeff_answer_mech_training_08	Отлично! Теперь железные бочки дважды подумают, прежде чем связываться с тобой
player_minus_ear	Я нихрена не слышу! Твои кореша вообще в курсе, что такое "звукоизоляция"?### У меня в голове аэродром открылся после пары выстрелов
jeff_joke_about_sound_isolation	Ты знаешь, мы как раз собирались её установить,сразу после джакузи и акустики.
player_sure_sound_isolation	Я, блять, серьезно.
jeff_accept_report_about_sound_isolation	Ладно, ладно, я понял. Разберемся с этим###В общем, вердикт: ты вроде бы не овощ, и умеешь нажимать кнопки.
jeff_training_complete	Будем считать, что стандартная тренировка завершена. Надо будет тебя попозже еще поднатаскать.
jeff_wait_night	А пока что мы ждем темноты, и перегоняем механоид поближе к городу.### Не желаешь партию в шахматы?
???_first_encounter	ВОТ ЭТО ДА! КАКАЯ УВЛЕКАТЕЛЬНАЯ ИСТОРИЯ! ЧЕЛОВЕК ОДЕРЖАЛ ГЕРОИЧЕСКУЮ ПОБЕДУ И ИДЕТ ЗА СВОЕЙ НАГРАДОЙ! "НЕ ЖЕЛАЕШЬ ПАРТИЮ В ШАХМАТЫ?" ВОТ КАК ОН ЭТО СКАЗАЛ, ПРЯМО МУРАШКИ ПО КОЖЕ. А ЧТО ЖЕ ДАЛЬШЕ БУДЕТ? ОНИ ПОЙДУТ КУПАТЬСЯ НА МОРЕ? О-О-О-О ДА, ВЕСЬ В ПРЕВДКУШЕНИИ
story_man_???_comment	Ты? Как ты смешь встревать в МОЮ историю? Я же сказал, что не желаю тебя видеть
???_im_here	МЕНЯ НЕ ВОЛНУЕТ, ЧЕГО ТЫ ЖЕЛАЕШЬ А ЧЕГО НЕТ. ЧТО Ж, ДАВАЙТЕ НЕМНОГО ПОТОРОПИМ СОБЫТИЯ
player_hear_drone	Э? Что за звук.
player_see_drone_01	В-о-о-о-о-о-у!!! Это же транспортный мангетдрон! ОХЕРЕТЬ! Никогда не видел его так близко! Вот это я понимаю - технологии.
jeff_see_drone_01	Какого черта он забыл в такой глуши? Неужто снова навигация глючит?
player_question_about_drone	Всмысле "снова"?
jeff_answer_about_drone_01	Эх, в общем, такой дрон однажды прилетел хрен пойми куда, и сбросил свой груз.
jeff_answer_about_drone_02	Куча жадных недоумков подумало, что к ним подвалила халява, и собрались вскрыть контейнер
jeff_answer_about_drone_03	Сработала охранная система, и... Говорят, что неделю потом убирали.
#
player_see_drone_02	Всегда было интересно, что он там перевозит. Вот бы он скинул мне один из своих контееров!
player_see_drone_03	Хм, кажется, я только что продал дьяволу душу. Может посмотрим, ради чего?
jeff_container_reaction_01	Губу только не раскатывай. Контейнер явно охраняется автоматикой.
jeff_container_reaction_02	Приблизишся ближе чем на 10 метров - и от тебя мокрого места не останется.
#
#
training_press_f	Подойдите к механоиду поближе и нажмите кнопку "F"
jeff_open_door	Джефф достает из кармана пульт управления, и нажимает на кнопку
to_jeff_02	Выбирал между версиями "ты рептилоид" и "ты - это мой сын из будущего". Никак не могу выбрать.
jeff_02	Рад тебя видеть. Если ты еще не передумал, сейчас последний шанс забыть о моем предложении.
quest_find_jeff	Задача: Найдите Джеффа###Подойдите к воротам при помощи клавиш W, A, S, D, и нажмите кнопку E.
begin_text_intro_01	Посреди пустоши, на заброшенном вокзале, 2 человека спорят возле большого железного ящика. Один из них - это ты, а второй - твой старый знакомый (Джефф).
begin_text_intro_02	Однажды Джефф пригласил (заставил силком) "помочь ему кое-в-чём". Вот ты и здесь.
begin_text_01	Да погоди ты, он сейчас сам откроется
begin_text_02	Ага, он открывается "сам" уже 5 минут, я бы уже давно открыл его с помощью "мистера открывашкина"
begin_text_03	Да убери от ящика монтировку, пока дрон не проснулся. Смотри, он как-то угрожающее мигать светодиодом начал.
begin_text_04	Так он мне подмигивает, типа "давай, парень, ломай, я не против, мне самому надоело ждать".
begin_text_05	О! Консоль отвисла! Вот теперь точно откроется.
begin_text_06	Эм... Что за черт? это ТАНК?
begin_text_07	Ну, вообщето мы называем его "мех"
begin_text_08	Так, тпрфу, когда ты сказал "помочь тебе", и даже не удосужился объяснить в чём, я ждал подвох. Но помогать тебе продать военную контрабанду...
begin_text_09	Да нет, ты неправильно понял. В общем, это самоделка. Я и группа энтузиастов построили его.
begin_text_10	Да ты угораешь!
begin_text_11	Я серьезно. Пока все занимались своими делами, я собрал самых одаренных механиков и инженеров во всего Илитира, что бы воплотить проект Защитник.
begin_text_12	"Проект защитник". лучше бы ты собрал одаренных маркетологов, честное слово. С таким названием ты его никому не продашь.
begin_text_13	Он не для продажи, а для защиты города. 
begin_text_14	Для защиты от кого?
begin_text_15	Потом объясню.
begin_text_16	Офигеть. Ты не мог начать объяснять когда мы ехали в поезде?
begin_text_17	Ну... В общем, с недавнего времени на планету стали прибывать какие-то отморозки, и ради забавы охотится на людей.
begin_text_18	Вау. Я едва дослушал этот нескончаемый рассказ. Ладно, ты построил робота для убийства людей, которые заслуживают смерти потому, что они убивают людей, ок. А я тут причем?
begin_text_19	Машине нужен пилот. Ты лучший кандидат.
begin_text_20	Лучший кандидат? Что-то я не помню, как меня награждали медалью "за превосходное пилотирование самодельных роботов". Почему я?
begin_text_21	Ты лучший стрелок в городе. И у тебя есть опыт обращения с механизмами.
begin_text_22	Умение попадать в цель с расстояния в 15 метров, несомненно, делает меня экспертом по пулевой стрельбе. А "опыт обращения с механизмами", это ты про тот раз, когда я включил в розетку электролебёдку? Все думали, что она на воздухе работает, наверное.
begin_text_23	Не ехидничай, я прекрасно знаю о твоих прошлых заслугах.
begin_text_24	Ты про что?
begin_text_25	Про осаду Катлимора.
begin_text_26	А, досье на меня добыл? Ладно, один хрен я уже пришел, что делать то надо?
begin_text_27	В общем, мы его почти закончили, установили все оборудование: оружие, энергощит, и прочее. Осталось только прогнать его через несколько тестов, что бы выявить какие нибудь скрытые дефекты.
begin_text_28	Найти дефекты? Похоже, придется засуить рукава. Честно говоря, эта штуковина выглядит, "как мусоный бак, полный печали". Циата такая. Из фильма. Не обижайся.
begin_text_29	Да, ты прав. Но когда мы покажем, на что эта штука способна, многие люди захотят вложить свои деньги на развитие программы... Название как нибудь переделаем.
begin_text_30	Да, кстати, а почему я последний кто узнает, что где то в одном из подвалов города собирают ОГРОМНЫЙ ТАНК?
begin_text_31	Потому что об этом почти никто не знает. Было бы много вопросов и еще больше неудобных ответов. Да и вообще его бы военные конфисковали. Чертовы засранцы.
begin_text_32	В общем полезай внутрь, начнем с самого простого, и по нарастающей.
debug_info_LBP	Степень яркости света при размытии
debug_info_BP	Количетсво разымытий света
debug_info_SP	Количетсво расхождений света
debug_info_ILLR	Фоновое свечение: красный	
debug_info_ILLG	Фоновое свечение: зелёный
debug_info_ILLB	Фоновое свечение: синий
null	null